param:name="ROOMS"
param:width="60"
param:height="60"
param:nextmap="LEVELBOSS"
param:floortxtr="3"
param:ceiltxtr="15"
param:midi="NAILS"
label:MAPSTART
0,0,0,0,0,0,0,0,0,0,0,0,0,0,0,0,0,0,0,0,0,0,0,0,0,0,0,0,0,0,0,0,0,0,0,0,0,0,0,0,0,0,0,0,0,0,0,0,0,0,0,0,0,0,0,0,0,0,0,0,
0,0,0,0,0,0,0,0,0,0,0,0,0,0,0,0,0,0,0,0,0,0,0,0,0,0,0,0,0,0,0,0,0,0,0,0,0,0,0,0,0,0,0,0,0,0,0,0,0,0,0,0,0,0,0,0,0,0,0,0,
0,0,0,0,0,0,0,0,0,0,0,0,0,0,0,0,0,0,0,0,0,0,0,0,0,0,0,0,0,0,0,0,0,0,0,0,0,0,0,0,0,0,0,0,0,0,0,0,0,0,0,0,0,0,0,0,0,0,0,0,
0,0,0,0,0,0,0,0,0,0,0,0,0,0,0,0,0,0,0,0,0,0,0,0,0,0,0,0,0,0,0,0,0,0,0,0,0,0,0,0,0,0,0,0,0,0,0,0,0,0,0,0,0,0,0,0,0,0,0,0,
0,0,0,37,37,37,37,37,31,37,32,37,37,37,31,37,37,0,0,0,0,0,0,0,0,0,0,0,0,0,0,0,0,0,0,0,0,0,0,0,0,0,0,0,0,0,0,0,0,0,0,0,0,0,0,0,0,0,0,0,
0,0,0,37,0,0,0,0,0,0,0,0,0,0,0,0,37,0,0,0,0,0,0,0,0,0,0,0,0,0,0,0,0,0,0,0,0,0,0,0,0,0,0,0,0,0,0,0,0,0,0,0,0,0,0,0,0,0,0,0,
0,0,0,32,0,0,5,0,0,0,0,0,0,5,0,0,37,0,0,0,0,0,0,0,0,38,38,38,38,38,38,38,0,0,0,0,0,0,0,0,0,0,0,0,0,0,0,0,0,0,0,0,0,0,0,0,0,0,0,0,
0,0,0,37,0,0,0,0,0,0,0,0,0,0,0,0,31,0,0,0,0,0,0,0,0,38,0,0,0,0,0,38,0,0,0,0,0,0,0,0,0,0,0,0,0,0,0,0,0,0,0,0,0,0,0,0,0,0,0,0,
0,0,0,31,0,0,0,0,0,29,29,0,0,0,0,0,37,38,38,38,38,38,38,38,0,38,0,0,0,0,0,38,0,0,0,0,0,0,0,0,0,0,0,0,0,0,0,0,0,0,0,0,0,0,0,0,0,0,0,0,
0,0,0,37,0,0,0,0,0,0,0,0,0,0,0,0,32,0,0,0,0,0,0,38,38,38,0,0,0,0,0,38,0,0,0,0,0,0,0,0,0,0,0,0,0,0,0,0,0,0,0,0,0,0,0,0,0,0,0,0,
0,0,0,32,0,0,5,0,0,0,0,0,0,5,0,0,37,0,0,0,0,0,0,38,0,38,0,0,0,0,0,38,0,0,0,0,0,0,0,0,0,0,0,0,0,0,0,0,0,0,0,0,0,0,0,0,0,0,0,0,
0,0,0,37,0,0,0,0,0,0,0,0,0,0,0,0,37,38,38,38,0,38,38,38,0,38,38,38,0,38,38,38,38,38,0,0,0,0,0,0,0,0,0,0,0,0,0,0,0,0,0,0,0,0,0,0,0,0,0,0,
0,0,0,31,0,0,0,0,0,29,29,0,0,0,0,0,0,0,0,0,0,0,0,0,0,0,0,0,0,0,0,0,0,38,0,0,0,0,0,0,0,0,0,0,0,0,0,0,0,0,0,0,0,0,0,0,0,0,0,0,
0,0,0,37,0,0,0,0,0,0,0,0,0,0,0,0,0,0,0,0,0,0,0,0,0,0,0,0,0,0,0,0,0,38,0,0,0,0,0,0,0,0,0,0,0,0,0,0,0,0,0,0,0,0,0,0,0,0,0,0,
0,0,0,37,0,0,5,0,0,0,0,0,0,5,0,0,37,38,38,38,0,38,38,38,0,38,38,38,0,38,38,38,38,38,0,0,0,0,0,0,0,0,0,0,0,0,0,0,0,0,0,0,0,0,0,0,0,0,0,0,
0,0,0,32,0,0,0,0,0,0,0,0,0,0,0,0,32,20,20,20,0,20,20,20,0,20,20,26,0,26,9,9,9,9,9,9,9,0,0,0,0,0,0,0,0,0,0,0,0,0,0,0,0,0,0,0,0,0,0,0,
0,0,0,37,0,0,0,0,0,29,29,0,0,0,0,0,37,20,0,0,0,0,20,0,0,0,20,9,0,0,0,0,0,0,0,0,9,0,0,0,0,0,0,0,0,0,0,0,0,0,0,0,0,0,0,0,0,0,0,0,
0,0,0,37,0,0,0,0,0,0,0,0,0,0,0,0,31,20,0,0,0,0,20,20,20,20,20,9,0,0,0,0,0,0,10,0,9,0,0,0,0,0,0,0,0,0,0,0,0,0,0,0,0,0,0,0,0,0,0,0,
0,0,0,31,0,0,5,0,0,0,0,0,0,5,0,0,37,20,0,0,0,0,20,0,0,0,0,9,0,0,0,0,0,0,0,0,9,0,0,0,0,0,0,0,0,0,0,0,0,0,0,0,0,0,0,0,0,0,0,0,
0,0,0,37,0,0,0,0,0,0,0,0,0,0,0,0,32,20,20,20,20,20,20,0,0,0,0,9,9,9,9,9,9,9,9,9,9,0,0,0,0,0,0,0,0,0,0,0,0,0,0,0,0,0,0,0,0,0,0,0,
0,0,0,37,0,0,0,0,0,0,0,0,0,0,0,0,37,0,0,0,30,30,30,30,30,30,30,30,30,30,30,30,30,30,30,30,30,30,30,30,30,30,30,30,30,22,22,22,0,0,0,0,0,0,0,0,0,0,0,0,
0,0,0,37,37,37,31,32,37,0,0,37,37,31,31,37,32,0,0,0,30,0,0,0,0,0,0,0,0,0,0,0,0,0,0,0,0,0,0,0,0,0,0,0,30,0,0,22,0,0,0,0,0,0,0,0,0,0,0,0,
0,0,0,0,0,0,0,0,35,0,0,35,0,0,0,0,0,0,0,0,30,0,0,0,0,0,0,0,0,0,0,0,0,0,0,0,0,0,0,0,0,0,0,0,30,0,0,22,0,0,0,0,0,0,0,0,0,0,0,0,
0,0,0,0,0,0,0,0,35,0,0,35,0,0,0,0,0,0,0,0,30,0,0,0,0,0,0,20,0,20,0,0,0,0,0,0,33,0,33,0,0,0,0,0,30,0,0,22,0,0,0,0,0,0,0,0,0,0,0,0,
0,0,0,0,0,0,0,35,35,0,0,35,35,0,0,0,0,0,0,0,30,0,0,0,0,24,20,20,0,20,20,24,0,0,21,33,33,0,33,33,21,0,0,0,30,0,0,22,22,22,22,22,0,0,0,0,0,0,0,0,
0,0,0,0,0,0,35,35,0,0,0,0,35,35,0,0,0,0,0,0,30,0,0,0,0,20,0,0,0,0,0,20,0,0,33,0,0,0,0,0,33,0,0,0,30,0,0,0,0,0,0,22,0,0,0,0,0,0,0,0,
0,0,0,0,0,35,35,0,0,0,0,0,0,35,35,0,0,0,0,0,30,0,0,0,0,20,0,0,0,0,0,20,0,0,33,0,0,0,0,0,33,0,0,0,30,0,0,0,0,0,0,22,0,0,0,0,0,0,0,0,
0,0,0,0,35,35,0,0,0,0,0,0,0,0,35,35,0,0,0,0,30,0,0,0,0,20,0,0,0,0,0,20,0,0,33,0,0,0,0,0,33,0,0,0,30,0,0,0,0,0,0,22,0,0,0,0,0,0,0,0,
35,35,35,35,35,0,0,0,0,29,29,0,0,0,0,27,28,28,28,28,27,0,0,0,0,20,0,0,0,0,0,20,0,0,33,0,0,0,0,0,33,0,0,0,30,0,0,0,0,0,0,22,0,0,0,0,0,0,0,0,
35,0,0,0,0,0,0,0,27,29,29,29,0,0,0,0,0,0,0,0,0,0,0,0,0,20,0,0,0,0,0,20,0,0,33,0,0,0,0,0,33,0,0,0,30,0,0,22,22,22,22,22,0,0,0,0,0,0,0,0,
35,0,0,0,0,0,0,29,29,29,29,29,29,0,0,0,0,0,0,0,0,0,0,0,0,24,20,20,20,20,20,24,0,0,21,33,33,33,33,33,21,0,0,0,30,0,0,0,0,0,0,22,0,0,0,0,0,0,0,0,
35,0,0,0,0,0,0,29,29,29,29,29,27,0,0,0,0,0,0,0,0,0,0,0,0,0,0,0,0,0,0,0,0,0,0,0,0,0,0,0,0,0,0,0,30,0,0,0,0,0,0,22,0,0,0,0,0,0,0,0,
35,0,0,0,0,0,0,0,27,29,29,29,0,0,0,0,0,0,0,0,0,0,0,0,0,0,0,0,0,0,0,0,0,0,0,0,0,0,0,0,0,0,0,0,30,0,0,0,0,0,0,22,0,0,0,0,0,0,0,0,
35,0,0,0,35,0,0,0,0,29,27,0,0,0,0,27,28,28,28,28,27,0,0,0,0,0,0,0,0,0,0,0,0,0,0,0,0,0,0,0,0,0,0,0,0,0,0,0,0,0,0,22,0,0,0,0,0,0,0,0,
35,0,0,0,35,35,0,0,0,0,0,0,0,0,35,30,30,30,30,30,30,0,0,0,0,5,23,23,23,23,23,5,0,0,26,32,32,32,32,32,26,0,0,0,30,0,0,22,22,22,22,22,0,0,0,0,0,0,0,0,
35,0,0,0,35,35,35,0,0,0,0,0,0,35,30,0,0,0,0,0,37,0,0,0,0,23,0,0,0,0,0,23,0,0,32,0,0,0,0,0,32,0,0,0,30,0,0,0,0,0,0,22,0,0,0,0,0,0,0,0,
35,0,0,0,35,0,35,35,0,0,0,0,35,30,0,0,0,0,0,0,30,0,0,0,0,23,0,0,0,0,0,23,0,0,32,0,0,0,0,0,32,0,0,0,30,0,0,0,0,0,0,22,0,0,0,0,0,0,0,0,
35,0,0,0,35,0,0,35,35,0,0,35,30,0,0,0,0,0,0,0,30,0,0,0,0,23,0,0,0,0,0,23,0,0,32,0,0,0,0,0,32,0,0,0,30,0,0,0,0,0,0,22,0,0,0,0,0,0,0,0,
35,35,35,35,35,0,0,0,30,0,0,30,0,0,0,0,0,0,0,0,30,0,0,0,0,23,0,0,0,0,0,23,0,0,32,0,0,0,0,0,32,0,0,0,30,0,0,22,22,22,22,22,0,0,0,0,0,0,0,0,
0,0,0,0,0,0,0,0,30,0,0,30,0,0,5,5,0,5,5,0,37,0,0,0,0,23,0,0,0,0,0,23,0,0,32,0,0,0,0,0,32,0,0,0,30,0,0,0,0,0,0,22,0,0,0,0,0,0,0,0,
0,0,0,0,0,0,0,0,30,0,0,30,0,0,5,0,0,0,5,0,30,0,0,0,0,5,23,23,0,23,23,5,0,0,26,32,32,0,32,32,26,0,0,0,37,0,0,0,0,0,0,22,0,0,0,0,0,0,0,0,
0,0,0,0,0,0,0,0,30,0,0,30,0,0,0,0,0,0,0,0,30,0,0,0,0,0,0,23,0,23,0,0,0,0,0,0,32,0,32,0,0,0,0,0,30,0,0,0,0,0,0,22,0,0,0,0,0,0,0,0,
0,0,0,0,0,0,0,0,30,0,0,30,0,0,5,0,0,0,5,0,30,0,0,0,0,0,0,0,0,0,0,0,0,0,0,0,0,0,0,0,0,0,0,0,30,0,0,22,22,22,22,22,0,0,0,0,0,0,0,0,
0,0,0,0,0,0,0,0,30,0,0,0,0,0,5,5,0,5,5,0,37,0,0,0,0,0,0,0,0,0,0,0,0,0,0,0,0,0,0,0,0,0,0,0,30,0,0,22,0,0,0,0,0,0,0,0,0,0,0,0,
0,0,0,0,0,0,0,0,30,0,0,0,0,0,0,0,0,0,0,0,30,0,0,0,0,0,0,0,0,0,0,0,0,0,0,0,0,0,0,0,0,0,0,0,30,0,0,22,0,0,0,0,0,0,0,0,0,0,0,0,
0,0,0,0,0,0,0,0,30,30,30,30,30,30,30,30,30,30,30,30,30,30,30,30,30,30,37,30,37,30,30,30,30,30,30,30,30,30,37,30,30,30,30,30,30,22,22,22,0,0,0,0,0,0,0,0,0,0,0,0,
0,0,0,0,0,0,0,0,0,0,0,0,0,0,0,0,0,0,0,0,0,0,0,0,0,0,0,0,0,0,0,0,0,0,0,0,0,0,0,0,0,0,0,0,0,0,0,0,0,0,0,0,0,0,0,0,0,0,0,0,
0,0,0,0,0,0,0,0,0,0,0,0,0,0,0,0,0,0,0,0,0,0,0,0,0,0,0,0,0,0,0,0,0,0,0,0,0,0,0,0,0,0,0,0,0,0,0,0,0,0,0,0,0,0,0,0,0,0,0,0,
0,0,0,0,0,0,0,0,0,0,0,0,0,0,0,0,0,0,0,0,0,0,0,0,0,0,0,0,0,0,0,0,0,0,0,0,0,0,0,0,0,0,0,0,0,0,0,0,0,0,0,0,0,0,0,0,0,0,0,0,
0,0,0,0,0,0,0,0,0,0,0,0,0,0,0,0,0,0,0,0,0,0,0,0,0,0,0,0,0,0,0,0,0,0,0,0,0,0,0,0,0,0,0,0,0,0,0,0,0,0,0,0,0,0,0,0,0,0,0,0,
0,0,0,0,0,0,0,0,0,0,0,0,0,0,0,0,0,0,0,0,0,0,0,0,0,0,0,0,0,0,0,0,0,0,0,0,0,0,0,0,0,0,0,0,0,0,0,0,0,0,0,0,0,0,0,0,0,0,0,0,
0,0,0,0,0,0,0,0,0,0,0,0,0,0,0,0,0,0,0,0,0,0,0,0,0,0,0,0,0,0,0,0,0,0,0,0,0,0,0,0,0,0,0,0,0,0,0,0,0,0,0,0,0,0,0,0,0,0,0,0,
0,0,0,0,0,0,0,0,0,0,0,0,0,0,0,0,0,0,0,0,0,0,0,0,0,0,0,0,0,0,0,0,0,0,0,0,0,0,0,0,0,0,0,0,0,0,0,0,0,0,0,0,0,0,0,0,0,0,0,0,
0,0,0,0,0,0,0,0,0,0,0,0,0,0,0,0,0,0,0,0,0,0,0,0,0,0,0,0,0,0,0,0,0,0,0,0,0,0,0,0,0,0,0,0,0,0,0,0,0,0,0,0,0,0,0,0,0,0,0,0,
0,0,0,0,0,0,0,0,0,0,0,0,0,0,0,0,0,0,0,0,0,0,0,0,0,0,0,0,0,0,0,0,0,0,0,0,0,0,0,0,0,0,0,0,0,0,0,0,0,0,0,0,0,0,0,0,0,0,0,0,
0,0,0,0,0,0,0,0,0,0,0,0,0,0,0,0,0,0,0,0,0,0,0,0,0,0,0,0,0,0,0,0,0,0,0,0,0,0,0,0,0,0,0,0,0,0,0,0,0,0,0,0,0,0,0,0,0,0,0,0,
0,0,0,0,0,0,0,0,0,0,0,0,0,0,0,0,0,0,0,0,0,0,0,0,0,0,0,0,0,0,0,0,0,0,0,0,0,0,0,0,0,0,0,0,0,0,0,0,0,0,0,0,0,0,0,0,0,0,0,0,
0,0,0,0,0,0,0,0,0,0,0,0,0,0,0,0,0,0,0,0,0,0,0,0,0,0,0,0,0,0,0,0,0,0,0,0,0,0,0,0,0,0,0,0,0,0,0,0,0,0,0,0,0,0,0,0,0,0,0,0,
0,0,0,0,0,0,0,0,0,0,0,0,0,0,0,0,0,0,0,0,0,0,0,0,0,0,0,0,0,0,0,0,0,0,0,0,0,0,0,0,0,0,0,0,0,0,0,0,0,0,0,0,0,0,0,0,0,0,0,0,
0,0,0,0,0,0,0,0,0,0,0,0,0,0,0,0,0,0,0,0,0,0,0,0,0,0,0,0,0,0,0,0,0,0,0,0,0,0,0,0,0,0,0,0,0,0,0,0,0,0,0,0,0,0,0,0,0,0,0,0,
label:MAPEND
player:position="49.5,26.5":
endlevel:position="34,17":
enemy:type="2":position="50.5,40":
enemy:type="2":position="50.5,40.5":
enemy:type="2":position="50.5,35.5":
enemy:type="2":position="49.5,37.5":
enemy:type="2":position="49.5,31":
enemy:type="2":position="50.5,33":
enemy:type="1":position="37.5,37.5":
enemy:type="1":position="27,28.5":
enemy:type="1":position="29.5,28.5":
enemy:type="2":position="42.5,26":
enemy:type="2":position="42.5,39":
enemy:type="2":position="37.5,43.5":
enemy:type="2":position="28,43.5":
enemy:type="2":position="23,42":
enemy:type="2":position="23,36":
enemy:type="2":position="23,27":
enemy:type="2":position="27.5,22":
enemy:type="2":position="37,22":
enemy:type="0":position="36.5,27.5":
enemy:type="0":position="39,29":
enemy:type="0":position="39,26":
enemy:type="0":position="27.5,39":
enemy:type="0":position="27,36.5":
enemy:type="0":position="29,36.5":
enemy:type="0":position="30,38":
enemy:type="0":position="30,36":
enemy:type="0":position="38.5,32.5":
enemy:type="0":position="36.5,32.5":
enemy:type="1":position="16.5,41.5":
enemy:type="1":position="18.5,36":
enemy:type="1":position="1.5,37":
enemy:type="1":position="3.5,37":
enemy:type="2":position="8,18.5":
enemy:type="2":position="5.5,16.5":
enemy:type="2":position="15,16.5":
enemy:type="2":position="14,13":
enemy:type="2":position="11.5,10":
enemy:type="2":position="7,12.5":
enemy:type="2":position="5,8.5":
enemy:type="2":position="9,6.5":
enemy:type="2":position="15,7":
enemy:type="2":position="9,11":
enemy:type="2":position="10.5,15.5":
enemy:type="2":position="15.5,37.5":
enemy:type="2":position="17,37":
enemy:type="2":position="16,35.5":
enemy:type="2":position="18,37.5":
enemy:type="2":position="15.5,36.5":
enemy:type="2":position="4.5,6.5":
enemy:type="2":position="5.5,5.5":
enemy:type="2":position="7.5,6":
enemy:type="2":position="7,8":
enemy:type="2":position="6.5,8.5":
enemy:type="2":position="10.5,7":
enemy:type="2":position="10.5,5.5":
enemy:type="2":position="12,6":
enemy:type="2":position="12,8.5":
enemy:type="2":position="14,9":
enemy:type="2":position="12,7":
enemy:type="2":position="15.5,5.5":
enemy:type="0":position="18,10":
enemy:type="0":position="27,8":
enemy:type="0":position="30,8":
enemy:type="0":position="23.5,16.5":
enemy:type="0":position="25.5,16.5":
decoration:type="3":position="33.5,17.5":
decoration:type="3":position="28.5,14.5":
decoration:type="3":position="34.5,16.5":
decoration:type="3":position="35.5,17.5":
decoration:type="3":position="34.5,18.5":
decoration:type="1":position="26.5,25.5":
decoration:type="1":position="30.5,25.5":
decoration:type="1":position="35.5,25.5":
decoration:type="1":position="39.5,25.5":
decoration:type="1":position="16.5,29.5":
decoration:type="1":position="19.5,29.5":
decoration:type="1":position="19.5,32.5":
decoration:type="1":position="16.5,32.5":
decoration:type="1":position="13.5,16.5":
decoration:type="1":position="6.5,16.5":
decoration:type="1":position="6.5,8.5":
decoration:type="1":position="13.5,8.5":
item:type="3":position="50.5,30.5":
item:type="4":position="50.5,33.5":
item:type="2":position="50.5,28.5":
item:type="2":position="49.5,32.5":
item:type="2":position="48.5,36.5":
item:type="2":position="50,37":
item:type="2":position="49,41":
item:type="1":position="49.5,39.5":
item:type="1":position="50,36":
item:type="1":position="48.5,31.5":
item:type="1":position="50.5,32":
item:type="1":position="48,40":
item:type="1":position="48,26":
item:type="0":position="45.5,22":
item:type="0":position="47.5,30.5":
item:type="0":position="50.5,41.5":
item:type="0":position="42,22":
item:type="0":position="33,32.5":
item:type="0":position="22.5,24.5":
item:type="0":position="23.5,43.5":
item:type="0":position="32.5,43.5":
item:type="0":position="42.5,42.5":
item:type="1":position="42.5,35.5":
item:type="1":position="42.5,44":
item:type="1":position="40,41.5":
item:type="1":position="35.5,38":
item:type="1":position="36,36":
item:type="1":position="38,36":
item:type="1":position="39.5,38":
item:type="1":position="27,38":
item:type="1":position="29,35.5":
item:type="1":position="22,39":
item:type="1":position="27.5,26.5":
item:type="1":position="29.5,27":
item:type="1":position="37,29":
item:type="1":position="36.5,26.5":
item:type="1":position="38.5,28":
item:type="2":position="22.5,23":
item:type="2":position="32,21.5":
item:type="2":position="29,32.5":
item:type="2":position="37.5,32.5":
item:type="2":position="35.5,44":
item:type="2":position="36,39.5":
item:type="2":position="35.5,38":
item:type="2":position="35.5,36.5":
item:type="2":position="35.5,35.5":
item:type="2":position="37.5,35.5":
item:type="2":position="39,35.5":
item:type="2":position="39,36.5":
item:type="2":position="39,38":
item:type="2":position="39.5,39.5":
item:type="2":position="27,35.5":
item:type="2":position="29.5,39":
item:type="2":position="30,36.5":
item:type="2":position="36,29":
item:type="2":position="39,27.5":
item:type="0":position="36,39":
item:type="0":position="39.5,39":
item:type="0":position="39,36.5":
item:type="0":position="28.5,38":
item:type="0":position="26.5,29.5":
item:type="0":position="26.5,29.5":
item:type="0":position="30.5,29.5":
item:type="0":position="30.5,29.5":
item:type="0":position="17.5,40.5":
item:type="0":position="15.5,42.5":
item:type="2":position="15.5,40.5":
item:type="2":position="17.5,42.5":
item:type="1":position="9.5,14.5":
item:type="1":position="11.5,13.5":
item:type="1":position="10,10":
item:type="1":position="9.5,6.5":
item:type="1":position="11.5,5.5":
item:type="2":position="5,9.5":
item:type="2":position="8,7.5":
item:type="2":position="5,13":
item:type="2":position="15,8.5":
item:type="0":position="5,20":
item:type="0":position="11,14":
item:type="0":position="14.5,11.5":
item:type="0":position="7.5,7":
item:type="1":position="8.5,27":
item:type="1":position="7,28.5":
item:type="1":position="8,28":
item:type="2":position="7,33.5":
item:type="2":position="7.5,34":
item:type="2":position="8,34.5":
